1111111111111
1001000000001
1000011111001
1N001100S0001
1111111111111
