11111111111111
10010000000011
10000111110001
1N0011000S0001
11111111111111
