             1111111111111111111
             1000000001000000001
             1000000000000000001
11111111111111000000000000000001
10000000000000000000000000000001
10000000000000000000000000000001
10000000000000000000000000000000
10000000000000000000000000000001
10000000000000000000000000000001
11111100000000111111111111111111
     1000000001
     1000000001
     10000N0001
     1111111111
