NO ./assets/north_texture.xpm
SO ./assets/south_texture.xpm
EA ./assets/east_texture.xpm
WE ./assets/west_texture.xpm

F 10,65,75
C 255,0,63

             1111111111111111111
             1000000001000000001
             1000000000000000001
11111111111111000000000000000001
10000000000000000000000000000001
10000000000000000000000000000001
10000000000000000000000000000001
10000000000000000000000000000001
10000000000000000000000000000001
11111100000000111111111111111111
     1000000001
     1000000001
     1000N00001
     1111111111
